На улице осталась мокрая лужа | Был дождь.
На столе лежат разбросанные документы | Кто-то искал что-то.
В комнате разбито зеркало | Было неудачное столкновение.
На дереве осталась разорванная одежда | Кто-то туда заполз.
В раковине остались остатки грязи | Кто-то только что помыл руки.
На пляже осталось много следов от ног | Много людей гуляло.
На кухне пустая кастрюля | Еда закончилась.
На полу видно большое количество крошек | Кто-то что-то ел.
В гостиной остался недопитый стакан вина | Кто-то здесь пил.
В кустах нашли разорванный рюкзак | Возможно, кто-то его обчистил.
На берегу обнаружены разбросанные обломки | Что-то тут ломали.
На полу лежат книги и ручка | Кто-то здесь учился.
На окне остались следы пальцев | Кто-то что-то открывал.
На подоконнике осталась грязная лужа | Кто-то что-то разлил.
На полу валяются разбитые игрушки | Кто-то что-то разбил.
На столе лежит сломанный ключ | Кто-то его поломал.
На полу осталась разорванная бумага | Кто-то что-то вырезал.
На стене видно отпечатки пальцев | Кто-то здесь держался.
На коврике осталась грязная обувь | Кто-то пришел с улицы.
На крыше видно следы птиц | Они здесь сидели.
На столе осталась разбитая чашка | Кто-то что-то разлил.
На полу лежит порванный пакет | Кто-то что-то доставал.
На стуле остался разорванный платок | Кто-то что-то вытирал.
На плите остался горячий кастрюля | Кто-то готовил еду.
На полу лежат разбросанные монеты | Кто-то что-то считал.
На полке видно пустое место | Кто-то взял что-то.
На столе остался пустой портфель | Кто-то взял свои вещи.
На полу остался разорванный пакет с мусором | Кто-то что-то выбрасывал.
На двери видны царапины | Кто-то что-то записал.
На полу лежат разбросанные иголки | Кто-то что-то шил.
На земле лежит разбитая бутылка | Кто-то что-то разбил.
На столе лежат остатки пиццы | Кто-то ел здесь.
На полу лежит грязная одежда | Кто-то сюда зашел.
На пляже остались следы от велосипедных колес | Кто-то катался.
На окне видны отпечатки лап | Кот тут прыгал.
На заборе осталась высокая царапина | Кто-то перелезал.
На полу лежат разбросанные краски | Кто-то что-то рисовал.
На окне осталось запотевшее стекло | Влага скапливалась.
На столе остался разорванный пакет с мукой | Кто-то что-то готовил.
На коврике видны следы мокрых следов | Кто-то принес влагу.
На полу видно разлитую жидкость | Кто-то что-то пролил.
На дереве осталась повислая ветка | Кто-то что-то сломал.
На столе лежит разорванный билет | Кто-то его испортил.
На полу видны разбросанные листы бумаги | Кто-то что-то писал.
На окне остались следы от лап | Собака тут прыгала.
На подоконнике остался высохший цветок | Кто-то забыл полить.
На стене видны выцветшие следы | Кто-то что-то убирал.
На столе лежат разбросанные карандаши | Кто-то что-то рисовал.
На площадке остались следы от роликов | Кто-то катался.
На полу осталась разбитая игрушка | Кто-то что-то сломал.
На стуле лежит разорванная книга | Кто-то что-то читал.
На столе видно разлитое масло | Кто-то что-то готовил.
На полу осталась выцветшая картина | Кто-то что-то нарисовал.
На столе лежит разбитая лампочка | Кто-то что-то разбил.
На полу видно следы обуви | Кто-то тут ходил.
На двери осталась висящая табличка | Кто-то что-то повесил.